######################
#                    #
#                    #
#                    #
#                    #
#                    #
#                    #
## #####   ######## ##
## ####    ######## ##
## #####    ####### ##
#                    #
#                    #
#                    #
#                    #
#                    #
#                    #
## #####   ######## ##
## ####    ######## ##
## #####    ####### ##
#                    #
#                    #
######################